         000000000         
         000000000         
         000000000         
00000000000000000000000000X
000000000000000000000000000
000000000000000000000000000
         000000Y00         
         000000000         
         000000000         