00000H00000H00000H00000H
00000H00000H00000H00000H
00H00H00H00H00H00H00H00H
00H00H00H00H00H00H00H00H
00H00H00H00H00H00H00H00H
00H00H00H00H00H00H00H00H
00H00000H00000H00000H000
X0H00000H00000H00000H000