00000H00000H00000
00000H00000H00000
00000H00000H00000
00000000000000000
00000000000000000
HHHH000000000HHHH
000000Y0000000000
00000000000000000
00000000000000000
00000000X00000000
00000000000000000
HHHH000000000HHHH
00000000000000000
00000000000000000
00000H00000H00000
00000H00000H00000
00000H00000H00000