HHHHHHHHHHHHHHHHHHHHHHHHHHHHHHHHHHHHHHHHHHHHHHHHHH
HXH00000H00000000000000000000000H00000H00000000000
H0HHH0H0H0HHHHHHHHHHHHH0HHHHHHH0H0HHH0H0HHH0HHHHH0
H0H000H0H00000H000H00000H000H000H0H0H0H000H000H000
H0H0HHH0HHHHH0H0H0H0HHHHH0H0H0HHH0H0H0HHHHHHH0H0HH
H0H0H000H000H0H0H0H00000H0H0H00000H000H0000000H0HY
H0H0H0HHH0H0H0H0H0HHHHH0H0H0HHHHHHH0HHH0HHHHHHH0H0
H000H000H0H0H0H0H0000000H0H0000000H0H000H0000000H0
HHHHHHH0H0H0H0H0HHHHHHHHH0HHHHHHHHH0H0HHH0HHHHHHH0
H00000H000H000000000H000H000000000000000H000000000