HHHHHHHHHXHHHHHHHHHHH
H000H000000000000000H
HH00H0HHHHHHHHHHHHH0H
H000H0H000H00000H000H
H00000HH00H00HH0H0HHH
H0H0000000H00H00H000H
HHHHHHHHH0000H00HH00H
H0H0000000H00H00H00HH
H000H0HHHHH0HH00H000H
HHH0HHH00000HHH000HHH
Y0H0HHH00H00H0HHH0HHH
H0HHHHH0HHH0H0HH00HHH
H0000000000000000000H
HHHHHHHHHHHHHHHHHHHHH